111111111111111
100P000C0000001
100000000000001
10000000C000001
100000000000001
100000000000001
100000000000001
100000000000001
100000000000001
10000E000000001
100000000000001
100000000000001
100000000000001
100000000000001
100000000000001
100000000000001
100000000000001
100000000000001
100000000000001
100000000000001
100000000000001
100000000000001
100000000000001
100000000000001
100000000000001
100000000000001
100000000000001
100000000000001
100000000000001
100000000000001
100000000000001
111111111111111